NO ./assets/textures/walls/test_wall_flesh.xpm42
SO ./assets/textures/walls/test_wall_flesh.xpm42
WE ./assets/textures/walls/test_wall_flesh.xpm42
EA ./assets/textures/walls/test_wall_flesh.xpm42
2N ./assets/textures/north_wall.xpm42
2S ./assets/textures/south_wall.xpm42
2W ./assets/textures/west_wall.xpm42
2E ./assets/textures/east_wall.xpm42

11111111111111111111111111111111111111111111111111111111111111
10000000000000000000000000000000000000000000000000000000000001
10222202220022220222002222022200222202220022220222002222022201
100000N0000000000000000000000000000000000000000000000000000001
10222202220022220222002222022200222202220022220222002222022201
10000000000000000000000000000000000000000000000000000000000001
11110000000000000000001111111111111100000000000000000000001111
10000000000000000000000000000000000000000000000000000000000001
10222202220022220222002222022200222202220022220222002222022201
10000000000000000000000000000000000000000000000000000000000001
10222202220022220222002222022200222202220022220222002222022201
10000000000000000000000000000000000000000000000000000000000001
11111111111111111111111111111111111111111111111111111111111111
