NO ./assets/textures/floors/f2.xpm42
SO ./assets/textures/floors/f2.xpm42
WE ./assets/textures/floors/f2.xpm42
EA ./assets/textures/floors/f2.xpm42

UP ./maps/floors/f3.cub
DOWN ./maps/floors/f1.cub

        1111111111111111111111111
        1000000000110000000000001
        1011000001110000000000001
        1001000000000000000000001
111111111011000001110000000000001
100000000011000001110111111111111
11110111111111011100000010001
11110111111111011101010010001
11000000110101011100000010001
100000000000000011000"0000001
1!0000000000000001101010010001
1100000111010101111101111000111
11110111 1110101 101111010001
11111111 1111111 111111111111
