NO ./assets/textures/floors/f3.xpm42
SO ./assets/textures/floors/f3.xpm42
WE ./assets/textures/floors/f3.xpm42
EA ./assets/textures/floors/f3.xpm42
"N ./assets/textures/floors/f2.xpm42
"S ./assets/textures/floors/f2.xpm42
"W ./assets/textures/floors/f2.xpm42
"E ./assets/textures/floors/f2.xpm42
$N ./assets/textures/floors/f4.xpm42
$S ./assets/textures/floors/f4.xpm42
$W ./assets/textures/floors/f4.xpm42
$E ./assets/textures/floors/f4.xpm42

UP ./maps/floors/f4.cub
DOWN ./maps/floors/f2.cub

        1111111111111111111111111
        1000000000110000000000001
        1011000001110000000000001
        1001000000000000000000001
111111111011000001110000000000001
100000000011000001110111111111111
11110111111111011100000010001
11110111111111011101010010001
1"000000110101011100000010001
10000000000000001100000$00001
1000S000020000001101010010001
1100000111010101111101111000111
11110111 1110101 101111010001
11111111 1111111 111111111111
